1d/IMS	Комплекс моделей, методов и средств комплексного перманентного совершенствования открытой технологии проектирования интеллектуальных систем
2e/IMS	Интеллектуальная метасистема IMS 
3d/БЗ	Онтология баз знаний и методика их коллективного проектирования
4d/УСК	Онтология Универсального Семантического Кода В.В. Мартынова
5e/БЗ	Среда коллективного проектирования баз знаний
6d/МОЗ	Онтология машин обработки знаний и методика их проектирования
7d/логики	Онтология логических моделей обработки знаний 
8d/темпор	Семантическая модель темпоральных рассуждений
9d/прогр	Онтология программ и языков программирования, чётко разделяющая семантические аспекты от синтаксических
10e/SCP	Среда визуального проектирования программ обработки знаний, представленных семантическими сетями
11d/нейро	Онтология искусственных нейронных сетей и онтология их проектирования
12e/нейро	Среда проектирования искусственных нейронных сетей
13d/ИСС	Онтологические модели баз знаний и решателей задач интеллектуальных справочных систем (по геометрии, дискретной математике, числовым моделям, истории, географии, химии, музыке)
14e/геом	Интеллектуальная справочная система по геометрии
15e/дискр	Интеллектуальная справочная система по дискретной математике
16e/числ	Интеллектуальная справочная система по числовым моделям
17e/история	Интеллектуальная справочная система по истории (Республики Беларусь, Древнего мира т.д.)
18d/ПИ	Онтология пользовательских интерфейсов интеллектуальных систем и методик их проектирования
19d/польз	Онтологические модели пользователей интеллектуальных систем
20d/трансл	Онтологическая модель отображения внешних текстов на внутренний язык смыслового представления знаний, а также модель визуализации знаний 
20.5d/ЕЯ	Онтологическая модель естественно-языкового интерфейса
21d/речь	Семантический анализ речи без промежуточного построения полного текста, эквивалентного речевому сообщению 
22e/ядроПИ	Унифицированное ядро мультимодальных пользовательских интерфейсов интеллектуальных систем
23e/визБЗ	Универсальная среда визуализации баз знаний (SCg-среда + SCn-среда)
24e/черт	Чертежный интерфейс интеллектуальных систем
25e/карт	Картографический интерфейс интеллектуальных систем
26d/компон	Онтология компонентов интеллектуальных систем и модель управления проектированием интеллектуальных систем
27e/упр.проект	Среда управления проектированием ostis-систем и их компонентов
28d/интегр	Онтологическая модель персонального интегратора информационных ресурсов и сервисов
29e/интегр	Персональный интегратор информационных ресурсов и сервисов (Интеллектуальный персональный ассистент)
30d/распр	От интеллектуальных систем к коллективам взаимодействующих интеллектуальных и традиционных компьютерным системам
31d/образов-е	Использование Технологии OSTIS в процессах управления изучением отдельных дисциплин и формированием компетенций специалистов в учебном заведении
32d/индив.обуч	Интеллектуальные системы индивидуального обучения
33e/геогр	Интеллектуальная справочная система по географии
34e/химия	Интеллектуальная справочная система по химии
35e/музыка	Интеллектуальная справочная система по музыкальной грамоте
36d/учащ	Онтологические модели обучаемых
37d/колл.обуч	Интеллектуальные системы коллективного обучения 
38d/уч.орг	Интеллектуальные учебные организации (интеллектуальные кафедры)
39e/каф	Интеллектуальная система поддержки деятельности инженерной кафедры
40e/конф	Интеллектуальная система поддержки подготовки и проведения конференций
41d/история	Онтология интеллектуальных систем в области истории
42e/минск	Интеллектуальная система-экскурсовод по городу Минску
43e/музей	Интеллектуальная система-экскурсовод по музею (например, художественному)
44d/персоны	Онтология персон
45e/персоны	Интеллектуальная справочная система по историческим персонам
46d/сав.пр-т	Проект комплексной гибкой автоматизации предприятия рецептурного производства (Савушкин продукт). Тактика и стратегия
47e/сав.пр-т	Система управления знаниями и комплексной автоматизацией предприятия рецептурного производства
48d/бизн-пр	Онтология бизнес-процессов предприятия рецептурного производства
49d/станд	Формализация стандартов (через Савушкин продукт выйти на соответствующие европейские структуры)
50d/умн.дом	Онтологическая модель умного дома
51e/умн.дом	Умный дом
52d/без-ть	Семантические модели, методы и средства управления информационной безопасностью интеллектуальных систем
53d/правонрш	Модели и методы анализа и профилактики правонарушений
54e/правонрш	Система анализа и профилактики правонарушений
55d/мед	Медицинские системы, основанные на знаниях
56d/энерг	Онтологические модели интеллектуальных систем в области энергетики
57e/энерг	Интеллектуальная система в области энергетики

